+______|____.
_____|____|_.
_____.____|__
____|___.__|_
____________=